NO ./imgs/path_to_the_north_texture
SO ./imgs/path_to_the_south_texture
WE ./imgs/path_to_the_west_texture
EA ./imgs/path_to_the_east_texture

F 10,10,10
C 10,10,10

11111111
101    1
10011 11
11011 11
10000  1
10001111
111  W01
1      1
11111111
