# **************************************************************************** #
#                                                                              #
#                                                         :::      ::::::::    #
#    hello.cub                                          :+:      :+:    :+:    #
#                                                     +:+ +:+         +:+      #
#    By: cmarouf <cmarouf@student.42.fr>            +#+  +:+       +#+         #
#                                                 +#+#+#+#+#+   +#+            #
#    Created: 2022/04/29 03:33:28 by anremiki          #+#    #+#              #
#    Updated: 2022/05/14 17:04:25 by anremiki         ###   ########.fr        #
#                                                                              #
# **************************************************************************** #

#	 ██████╗██╗   ██╗██████╗ ██████╗ ██████╗ 
#	██╔════╝██║   ██║██╔══██╗╚════██╗██╔══██╗
#	██║     ██║   ██║██████╔╝ █████╔╝██║  ██║
#	██║     ██║   ██║██╔══██╗ ╚═══██╗██║  ██║
#	╚██████╗╚██████╔╝██████╔╝██████╔╝██████╔╝
#	 ╚═════╝ ╚═════╝ ╚═════╝ ╚═════╝ ╚═════╝ 

NO ./imgs/bricks.xpm
SO ./imgs/blackstone.xpm
WE ./imgs/birch_planks.xpm
EA ./imgs/bookshelf.xpm

F 10,10,255
C 10,10,10

11111111
1011   1
1000  11
11D11 11
10000L 1#MAP
10001111
111L W01
1 D     1
11111111
*
11111111
11111111
11111111
11111111
11111111#ROOF
11111111
11111111
111111111
11111111
*
00000000
00000000
00000000
00000000
00000000#FLOOR
00000000
00000000
000000000
00000000
