# **************************************************************************** #
#                                                                              #
#                                                         :::      ::::::::    #
#    hello.cub                                          :+:      :+:    :+:    #
#                                                     +:+ +:+         +:+      #
#    By: cmarouf <cmarouf@student.42.fr>            +#+  +:+       +#+         #
#                                                 +#+#+#+#+#+   +#+            #
#    Created: 2022/04/29 03:33:28 by anremiki          #+#    #+#              #
#    Updated: 2022/05/09 16:21:45 by cmarouf          ###   ########.fr        #
#                                                                              #
# **************************************************************************** #

#	 ██████╗██╗   ██╗██████╗ ██████╗ ██████╗ 
#	██╔════╝██║   ██║██╔══██╗╚════██╗██╔══██╗
#	██║     ██║   ██║██████╔╝ █████╔╝██║  ██║
#	██║     ██║   ██║██╔══██╗ ╚═══██╗██║  ██║
#	╚██████╗╚██████╔╝██████╔╝██████╔╝██████╔╝
#	 ╚═════╝ ╚═════╝ ╚═════╝ ╚═════╝ ╚═════╝ 
NO ./imgs/bricks.xpm
SO ./imgs/blackstone.xpm
WE ./imgs/birch_planks.xpm
EA ./imgs/bookshelf.xpm

F 10,10,10
C 10,10,10

11111111
101    1
10011 11
11011 11
10000L 1
10001111
111L W01
1      1
11111111