# **************************************************************************** #
#                                                                              #
#                                                         :::      ::::::::    #
#    map.cub                                            :+:      :+:    :+:    #
#                                                     +:+ +:+         +:+      #
#    By: cmarouf <qatar75020@gmail.com>             +#+  +:+       +#+         #
#                                                 +#+#+#+#+#+   +#+            #
#    Created: 2022/04/29 03:33:28 by anremiki          #+#    #+#              #
#    Updated: 2022/05/01 02:18:18 by anremiki         ###   ########.fr        #
#                                                                              #
# **************************************************************************** #

#	 ██████╗██╗   ██╗██████╗ ██████╗ ██████╗ 
#	██╔════╝██║   ██║██╔══██╗╚════██╗██╔══██╗
#	██║     ██║   ██║██████╔╝ █████╔╝██║  ██║
#	██║     ██║   ██║██╔══██╗ ╚═══██╗██║  ██║
#	╚██████╗╚██████╔╝██████╔╝██████╔╝██████╔╝
#	 ╚═════╝ ╚═════╝ ╚═════╝ ╚═════╝ ╚═════╝ 
NO ./imgs/path_to_the_north_texture
SO ./imgs/path_to_the_south_texture
WE ./imgs/path_to_the_west_texture
EA ./imgs/path_to_the_east_texture

F 10,10,10
C 10,10,10

1111111111111111111111111111111111111111111111
1000000000000000000000000000000000000000000001
1000000000000000000000000000000000000000000001
1000000000000000000000000000000000000000000001
1000000000000000000000000000000000000000000001
1000000000000000000000000000000000000000000001
1000000000000000000000000000000000000000000001
1000000000000000000000000000000000000000000001
1000000000000000000000000000000000000000000001
1000000000000000000000000000000000000000000001
1000000000000000000000000000000000000000000001
1000000000000000000000000000000000000000000001
1000000000000000000000000000000000000000000001
1000000000000000000000000000000000000000000001
1000000000000000000000000000000000000000000001
1000000000000000000000000000000000000000000001
1000000000000000000000000000000000000000000001
1000000000000000000000000000000000000000000001
1000000000000000000000000000000000000000000001
1000000000000000000000000000000000000000000001
1000000000000000000000N00000000000000000000001
1000000000000000000000000000000000000000000001
1111111111111111111111111111111111111111111111
