# **************************************************************************** #
#                                                                              #
#                                                         :::      ::::::::    #
#    new.cub                                            :+:      :+:    :+:    #
#                                                     +:+ +:+         +:+      #
#    By: anremiki <marvin@42.fr>                    +#+  +:+       +#+         #
#                                                 +#+#+#+#+#+   +#+            #
#    Created: 2022/05/17 16:12:43 by anremiki          #+#    #+#              #
#    Updated: 2022/05/17 17:38:32 by anremiki         ###   ########.fr        #
#                                                                              #
# **************************************************************************** #

#	 ██████╗██╗   ██╗██████╗ ██████╗ ██████╗ 
#	██╔════╝██║   ██║██╔══██╗╚════██╗██╔══██╗
#	██║     ██║   ██║██████╔╝ █████╔╝██║  ██║
#	██║     ██║   ██║██╔══██╗ ╚═══██╗██║  ██║
#	╚██████╗╚██████╔╝██████╔╝██████╔╝██████╔╝
#	 ╚═════╝ ╚═════╝ ╚═════╝ ╚═════╝ ╚═════╝ 

NO ./imgs/bricks.xpm
SO ./imgs/blackstone.xpm
WE ./imgs/birch_planks.xpm
EA ./imgs/bookshelf.xpm

F 10,10,10
C 10,10,10

# Walls, Floors and doors

111111111111111111111111111111111111111111111111111111
100000000000000000000000000000000000000000000000000001
100000000000000000000000000000000000000000000000000001
100000000000000000000000000000000000000000000000000001
100000000000000000000000000000000000000000000000000001
100000000111111111111111111111111111111111111000000001
100000000100000000000000000000000000000000001000000001
111111111100000000000000000000000000000000001111111111
100000000111111111111111111011111111111111001000000001
100000000100100000010000000000000000000001001000000001
100000000 0010000001000000000000000000000100 000000001
100000000100000000010000000000000000000000001000000001
100000000 0010000000000000000000000000000100 0000N0001
100000000100100000000000000000000000000001001000000001
100000000100111111111111111011111111111111001000000001
111111111100000000000000000000000000000000001111111111
100000000100000000000000000000000000000000001000000001
100000000111111111111111111011111111111111111000000001
100000000000000000000000011 11000000000000000000000001
100000000000000000000000010001000000000000000000000001
100000000000000000000000010001000000000000000000000001
100000000000000000000000010001000000000000000000000001
111111111111111111111111111111111111111111111111111111
*

# Ceilings

111111111111111111111111111111111111111111111111111111
111111111111111111111111111111111111111111111111111111
111111111111111111111111111111111111111111111111111111
111111111111111111111111111111111111111111111111111111
111111111111111111111111111111111111111111111111111111
111111111111111111111111111111111111111111111111111111
111111111111111111111111111111111111111111111111111111
111111111111111111111111111111111111111111111111111111
111111111111111111111111111111111111111111111111111111
111111111111100000000000000000000000000001111111111111
111111111111100000000000000000000000000001111111111111
111111111111100000000000000000000000000001111111111111
111111111111100000000000000000000000000001111111111111
111111111111100000000000000000000000000001111111111111
111111111111111111111111111111111111111111111111111111
111111111111111111111111111111111111111111111111111111
111111111111111111111111111111111111111111111111111111
111111111111111111111111111111111111111111111111111111
111111111111111111111111111111111111111111111111111111
111111111111111111111111111111111111111111111111111111
111111111111111111111111111111111111111111111111111111
111111111111111111111111111111111111111111111111111111
111111111111111111111111111111111111111111111111111111
*

# Sprites

000000000000000000000000000000000000000000000000000000
000000000000000000000000000000000000000000000000000000
000000000000000000000000000000000000000000000000000000
000000000000000000000000000000000000000000000000000000
000000000000000000000000000000000000000000000000000000
000000000000000000000000000000000000000000000000000000
000000000000000000000000000000000000000000000000000000
000000000000000000000000000000000000000000000000000000
000000000000000000000000000000000000000000000000000000
000000000000000000000000000000000000000000000000000000
000000000000000000000000000000000000000000000000000000
000000000000000000000000000000000000000000000000000000
000000000000000000000000000000000000000000000000000000
000000000000000000000000000000000000000000000000000000
000000000000000000000000000000000000000000000000000000
000000000000000000000000000000000000000000000000000000
000000000000000000000000000000000000000000000000000000
000000000000000000000000000000000000000000000000000000
000000000000000000000000000000000000000000000000000000
000000000000000000000000000000000000000000000000000000
000000000000000000000000000000000000000000000000000000
000000000000000000000000000L00000000000000000000000000
000000000000000000000000000000000000000000000000000000
