NO ./textures/sentry_stone.xpm
SO ./textures/sandry_stone.xpm
WE ./textures/carved_stone.xpm
EA ./textures/grassry_stone.xpm
F 220,100,0
C 225,30,0

1111111111111111111111111
1000000000110000000000001
1011000001110000000000001
100100000000000000000000111111111
111111111011000001110000000000001
100000000011000001110111111111111
11110111111111011100000010001
11110111111111011101010010001
1100000011010101110000001000111111111111111111111111111111111111111111111111
1000000000000000000000001000000000000000000000000000000000000000000000000001
100000N000000000000101001000000000000000000000000000000000000000000000000001
1100000111010101111101111000111111111111111111111111111111111111111111111111
11110111 1110101 101111010001
11111111 1111111 111111111111
