SO ./textures/sandry_stone.xpm
NE ./textures/sentry_stone.xpm
WE ./textures/carved_stone.xpm
EA ./textures/grassry_stone.xpm

C 255,30,0
F 220,100,0


111111111111111111111111111
100000000011000000000000111
101100000111000000000000111
100100000000000000000000111111111
111111111011000001110000000000001
100000000011000001110111111111111
11110111111111011100000010001
11110111111111011101010010001
11000000110101011100000010001
10000000000000001100000010001
10000000000000001101010010001
11000001110101011111011110N0111
11110111111101011101111010001
11111111111111111111111111111