# **************************************************************************** #
#                                                                              #
#                                                         :::      ::::::::    #
#    new.cub                                            :+:      :+:    :+:    #
#                                                     +:+ +:+         +:+      #
#    By: cmarouf <cmarouf@student.42.fr>            +#+  +:+       +#+         #
#                                                 +#+#+#+#+#+   +#+            #
#    Created: 2022/05/17 16:12:43 by anremiki          #+#    #+#              #
#    Updated: 2022/05/23 18:13:55 by cmarouf          ###   ########.fr        #
#                                                                              #
# **************************************************************************** #

#	 ██████╗██╗   ██╗██████╗ ██████╗ ██████╗ 
#	██╔════╝██║   ██║██╔══██╗╚════██╗██╔══██╗
#	██║     ██║   ██║██████╔╝ █████╔╝██║  ██║
#	██║     ██║   ██║██╔══██╗ ╚═══██╗██║  ██║
#	╚██████╗╚██████╔╝██████╔╝██████╔╝██████╔╝
#	 ╚═════╝ ╚═════╝ ╚═════╝ ╚═════╝ ╚═════╝ 

NO ./bonus/imgs/Statue.xpm
SO ./bonus/imgs/blackstone.xpm
WE ./bonus/imgs/birch_planks.xpm
EA ./bonus/imgs/bookshelf.xpm

F 10,10,10
C 10,10,10

# Walls, Floors and doors

111111111111111111111111111111111111111111111111111111
100000000000000000100000000000000001000000000000000001
100000000000000000 0000000000000000 000000000000000001
100000000000000000100000000000000001000000000000000001
100000000000000000100000000000000001000000000000000001
100000000111111111111111111 11111111111111111000000001
100000000100000000000000000000000000000000001000000001
111111111100000000000000000000000000000000001111111111
100000000100111111111111111011111111111111001000000001
100000000100100000000000000000000000000001001000000001
100000000 0010000000000000000000000000000100 000000001
100000000100000000000000000000000000000000001000000001
100000000 0010000000000000000000000000000100 000000001
100000000100100000000000000000000000000001001000000001
100000000100111111111111111011111111111111001000000001
111111111100000000000000000000000000000000001111111111
100000000100000000000000000000000000000000001000000001
100000000111 11111111111111011111111111111 11000000001
100000000000000100000000011 11000000000100000000000001
100000000000000100000000010001000000000100000000000001
1000000000000001000000000 000 000000000100000000000001
100000000000000100000000010N01000000000100000000000001
111111111111111111111111111111111111111111111111111111
*

# Ceilings

111111111111111111111111111111111111111111111111111111
111111111111111111111111111111111111111111111111111111
111111111111111111111111111111111111111111111111111111
111111111111111111111111111111111111111111111111111111
111111111111111111111111111111111111111111111111111111
111111111111111111111111111111111111111111111111111111
111111111111111111111111111111111111111111111111111111
111111111111111111111111111111111111111111111111111111
111111111111111111111111111111111111111111111111111111
111111111111100000000000000000000000000001111111111111
111111111111100000000000000000000000000001111111111111
111111111111100000000000000000000000000001111111111111
111111111111100000000000000000000000000001111111111111
111111111111100000000000000000000000000001111111111111
111111111111111111111111111111111111111111111111111111
111111111111111111111111111111111111111111111111111111
111111111111111111111111111111111111111111111111111111
111111111111111111111111111111111111111111111111111111
111111111111111111111111111111111111111111111111111111
111111111111111111111111111111111111111111111111111111
111111111111111111111111111111111111111111111111111111
111111111111111111111111111111111111111111111111111111
111111111111111111111111111111111111111111111111111111
*

# Sprites

000000000000000000000000000000000000000000000000000000
000000000000000000000000000000000000000000000000000000
000000000000000000000000000000000000000000000000000000
000000000000000000000000000000000000000000000000000000
000000000000000000000000000000000000000000000000000000
000000000000000000000000000000000000000000000000000000
000000000000000000000000000000000000000000000000000000
000000000000000000000000000000000000000000000000000000
000000000000000000000000000000000000000000000000000000
000000000000000000000000000000000000000000000000000000
000000000000000000000000000000000000000000000000000000
00000000000000000000000C0000U0000000000000000000000000
000000000000000000000000000000000000000000000000000000
000000000000000000000000000000000000000000000000000000
000000000000000000000000000000000000000000000000000000
000000000000000000000000000000000000000000000000000000
000000000000000000000000000000000000000000000000000000
000000000000000000000000000000000000000000000000000000
000000000000000000000000000000000000000000000000000000
000000000000000000000000000000000000000000000000000000
000000000000000000000000000000000000000000000000000000
000000000000000000000000000L00000000000000000000000000
000000000000000000000000000000000000000000000000000000
