NO ./imgs/path_to_the_north_texture
SO ./imgs/path_to_the_south_texture


WE ./imgs/path_to_the_west_texture
EA ./imgs/path_to_the_east_texture

F 220,100,0


C 225,30,0

11111111111
10000000001
10000000001
1000000000111111
10000N0000100001
1000000000100001
1000000000111111
10000000001
11111111111
