NO ./imgs/path_to_the_north_texture
SO ./imgs/path_to_the_south_texture


WE ./imgs/path_to_the_west_texture
EA ./imgs/path_to_the_east_texture

F 220,100,0


C 225,30,0

11111111
1  1   1
1 011 11
11011 11
10S0  11
1   1111
11   001
11111101
11111111
