NO ./imgs/path_to_the_north_texture
SO ./imgs/path_to_the_south_texture


WE ./imgs/path_to_the_west_texture
EA ./imgs/path_to_the_east_texture

F 220,100,0


C 225,30,0

11111111
101    1
10000011
11001 11
100000 1
10001111
11N00001
11111101
11111111
