11111111
10100001
1000C001
10P00001
1000 001
11 11111
110E0001
11111101
111  111
