NO ./textures/path_to_the_north_texture
SO ./textures/path_to_the_south_texture


WE ./textures/path_to_the_west_texture
EA ./textures/path_to_the_east_texture

F 220,100,0


C 225,30,0

111111111
101000011
100101011
10P1D1011
100000011
110011111
11N00001
11111101
10011001
111  111
