NO ./textures/path_to_the_north_texture
SO ./textures/path_to_the_south_texture


WE ./textures/path_to_the_west_texture
EA ./textures/path_to_the_east_texture

F 220,100,0


C 225,30,0

11111111
10100001
10001101
10001101
10000001
10E01111
11000001
11111101
111  111
