NO ./textures/path_to_the_north_texture
SO ./textures/path_to_the_south_texture


WE ./textures/path_to_the_west_texture
EA ./textures/path_to_the_east_texture

F 220,100,0


C 225,30,0

 
 11111111 
 10100001 
 10000 01 
 100W0101 
 10000001 
 10001111 
 11000001 
 11111111 
 111  111 
  
