SO ./mandatory/textures/sandry_stone.xpm
NO ./mandatory/textures/sentry_stone.xpm
WE ./mandatory/textures/carved_stone.xpm
EA ./mandatory/textures/grassry_stone.xxpm

C 25,30,0
F 13,15,33

11111111
1N00 1
11111111
