SO ./mandatory/textures/sandry_stone.xpm
NO ./mandatory/textures/sentry_stone.xpm
WE ./mandatory/textures/carved_stone.xpm
EA ./mandatory/textures/grassry_stone.xpm

C 255,255,255
F 255,255,0


1111
1N01
1011
111