NO ./mandatory/textures/sentry_stone.xpm
SO ./mandatory/textures/sandry_stone.xpm
WE ./mandatory/textures/carved_stone.xpm
EA ./mandatory/textures/grassry_stone.xpm

F 13,15,20
C 25,30,0

1111111
10000001
1000 0001
1000 00001
1000N00001
100000001
10000001
1111111
