NO ./mandatory/textures/sentry_stone.xpm
SO ./mandatory/textures/sandry_stone.xpm
WE ./mandatory/textures/carved_stone.xpm
EA ./mandatory/textures/grassry_stone.xpm

F 13,0,250
C 25,0,250

1111111111111111111111111
1000000000110000000000001
1011000001110000000000001
100100000000000000000000111111111
111111111011000001110000000000001
100000000011000001110111111111111
11110111111111011100000010001
11110111111111011101010010001
11000000110101011100000010001
10000000000000001100000010001
10000000000000001101010010001
110000N1110101011111011110001
11110111111101011101111010001
11111111111111111111111111111


