# **************************************************************************** #
#                                                                              #
#                                                         :::      ::::::::    #
#    new.cub                                            :+:      :+:    :+:    #
#                                                     +:+ +:+         +:+      #
#    By: cmarouf <cmarouf@student.42.fr>            +#+  +:+       +#+         #
#                                                 +#+#+#+#+#+   +#+            #
#    Created: 2022/05/17 16:12:43 by anremiki          #+#    #+#              #
#    Updated: 2022/06/22 13:21:25 by cmarouf          ###   ########.fr        #
#                                                                              #
# **************************************************************************** #

#	 ██████╗██╗   ██╗██████╗ ██████╗ ██████╗ 
#	██╔════╝██║   ██║██╔══██╗╚════██╗██╔══██╗
#	██║     ██║   ██║██████╔╝ █████╔╝██║  ██║
#	██║     ██║   ██║██╔══██╗ ╚═══██╗██║  ██║
#	╚██████╗╚██████╔╝██████╔╝██████╔╝██████╔╝
#	 ╚═════╝ ╚═════╝ ╚═════╝ ╚═════╝ ╚═════╝ 

NO ./bonus/imgs/bricks.xpm
SO ./bonus/imgs/blackstone.xpm
WE ./bonus/imgs/birch_planks.xpm
EA ./bonus/imgs/bookshelf.xpm
OW ./bonus/imgs/wallbrick.xpm
F1 ./bonus/imgs/blackstone.xpm
F2 ./bonus/imgs/blackstone.xpm
R1 ./bonus/imgs/vertvent.xpm
R2 ./bonus/imgs/blackstone.xpm

F 10,10,255
C 10,255,2

# Walls, Floors and doors
11111111111111111111111111111111111111111111111111111111111111
10000000000000000010000000000000000100000000000000000100000001
100000000000000000 0000000000000000 00000000000000000100000003
10000000000000000010000000000000000100000000000000000100000001
10000000000000000010000000000000000100000000000000000111111111
100000000111111111111111111 1111111111111111100000000111111111
10000000010000000000000000000000000000000000100000000111111111
11111111110000000000000000000000000000000000111111111111111111
10000000010011111111111111101111111111111100100000000111111111
10000000010010000000000000000000000000000100100000000111111111
100000000 0010000000000000000000000000000100 00000000111111111
10000000010000000000000000000000000000000000100000000111111111
100000000 0010000000000000000000000000000100 00000000111111111
10000000010010000000000000000000000000000100100000000111111111
10000000010011111111111111101111111111111100100000000111111111
11111111110000000000000000000000000000000000111111111111111111
10000000010000000000000000000000000000000000100000000111111111
100000000111 11111111111111011111111111111 1100000000111111111
100000000000000100000000011 1100000000010000000000000111111111
10000000000000010000000001000100000000010000000000000111111111
1000000000000001000000000 000 00000000010000000000000111111111
100000000000000100000000010N0100000000010000000000000111111111111111111111111111111111111111
11111111111111111111111111111111111111111111111111111111111111
*
11111111111111111111111111111111111111111111111111111111111111
11111111111111111111111111111111111111111111111111111111111111
11111111111111111111111111111111111111111111111111111111111111
11111111111111111111111111111111111111111111111111111111111111
11111111111111111111111111111111111111111111111111111111111111
11111111111111111111111111111111111111111111111111111111111111
11111111111111111111111111111111111111111111111111111111111111
11111111111111111111111111111111111111111111111111111111111111
11111111111111111111111111111111111111111111111111111111111111
11111111111110000000000000000000000000000111111111111111111111
11111111111110000000000000000000000000000111111111111111111111
11111111111110000000000000000000000000000111111111111111111111
11111111111110000000000000000000000000000111111111111111111111
11111111111110000000000000000000000000000111111111111111111111
11111111111111111111111111111111111111111111111111111111111111
11111111111111111111111111111111111111111111111111111111111111
11111111111111111111111111111111111111111111111111111111111111
11111111111111111111111111111111111111111111111111111111111111
11111111111111111111111111111111111111111111111111111111111111
11111111111111111111111111111111111111111111111111111111111111
11111111111111111111111111111111111111111111111111111111111111
11111111111111111111111111111111111111111111111111111111111111111111111111111111111111111111
11111111111111111111111111111111111111111111111111111111111111
*
L0000000000000000000000000000000000000000000000000000000000000
000000000000000000000000000000000000000000000000000000000000P0
000000000000000000000000000000000000000000000000000000G0000000
000000000000000000000000000000000000000000000000000000000000P0
00000000000000000000000000000000000000000000000000000000000000
00000000000000000000000000000000000000000000000000000000000000
00000000000000000000000000000000000000000000000000000000000000
00000000000000000000000000000000000000000000000000000000000000
00000000000000000000000000000000000000000000000000000000000000
00000000000000000000000000000000000000000000000000000000000000
00000000000000000000Y0G0L0B0C0R000G000000000000000000000000000
00000000000000000000000C0000U000000000000000000000000000000000
00000000000000000000000000000000000000000000000000000000000000
00000000000000000000000000K00K00000000000000000000000000000000
00000000000000000000000000000000000000000000000000000000000000
00000000000000000000000000000000000000000000000000000000000000
00000000000000000000000000000000000000000000000000000000000000
00000000000000000000000000000000000000000000000000000000000000
00000000000000000000000000000000000000000000000000000000000000
000000000000000000000000000KK000000000000000000000000000000000
000000000000000000000000000000000000000L0000000000000000000000
000000000L00000000000000000L000000000000000000000000000000000L000000000000000000000000000000
0000000000000000000000000000000L000000000000000000000000000000
