# **************************************************************************** #
#                                                                              #
#                                                         :::      ::::::::    #
#    warped.cub                                         :+:      :+:    :+:    #
#                                                     +:+ +:+         +:+      #
#    By: anremiki <marvin@42.fr>                    +#+  +:+       +#+         #
#                                                 +#+#+#+#+#+   +#+            #
#    Created: 2022/05/30 14:21:47 by anremiki          #+#    #+#              #
#    Updated: 2022/05/31 01:43:12 by anremiki         ###   ########.fr        #
#                                                                              #
# **************************************************************************** #

#	 ██████╗██╗   ██╗██████╗ ██████╗ ██████╗ 
#	██╔════╝██║   ██║██╔══██╗╚════██╗██╔══██╗
#	██║     ██║   ██║██████╔╝ █████╔╝██║  ██║
#	██║     ██║   ██║██╔══██╗ ╚═══██╗██║  ██║
#	╚██████╗╚██████╔╝██████╔╝██████╔╝██████╔╝
#	 ╚═════╝ ╚═════╝ ╚═════╝ ╚═════╝ ╚═════╝ 

#NO -> North
#SO -> South
#WE -> West
#EA -> East
#OW -> Outside walls
#F1 -> Floor 1
#F2 -> Floor 2
#R1 -> Roof 1
#R2 -> Roof 2

NO ./bonus/imgs/cracked_red.xpm
SO ./bonus/imgs/warped_south.xpm
WE ./bonus/imgs/clean_red.xpm
EA ./bonus/imgs/warped_east.xpm
OW ./bonus/imgs/warped_out.xpm
F1 ./bonus/imgs/warped_floor.xpm
F2 ./bonus/imgs/blackstone.xpm
R1 ./bonus/imgs/warped_roof.xpm
R2 ./bonus/imgs/blackstone.xpm


F 30,30,30
C 10,10,10

1111111111111111111
1111110000000001111
11100 00S000000 001
11100111 1111111001
1100000000000011101
1111101001111110101
1010101010000110101
1 10101111110110101
10001 11111101101 1
1110101111110110101
1110001111100110001
1111100000000000001
1011111101101101111
10 0000001101000003
111111 111101111111
1111110000000001111
1111110011111111111
1111110000111110001
1111111111111111111
*
1111111111111111111
1111110000000001111
1111110000000001111
1111111111111111111
1111111111111111111
1111111111111111111
1111111111111111111
1111111111111111111
1111111111111111111
1111111111111111111
1111111111111111111
1111111111111111111
1111111111111111111
1111111111111111111
1111111111111111111
1111111111111111111
1111111111111111111
1111111111111111111
1111111111111111111
*
0000000000000000000
0000000000000000000
000L0000R00000000L0
0000000000000000000
0000000000000000000
00000000U0000000000
00000Y000000B00C0Y0
0000000000000000000
0R00000000000000000
0000000000000000000
0000000000000000000
00000G00000000000R0
0000000000000000000
0U00000000000L0000R
0000000000000000000
0000000000000000000
0000000000000000000
000000000C00000PRK0
0000000000000000000
